    C  0,139,139
NO /nfs/homes/iantar/Desktop/cub3d_team/textures/GrasswallL.xpm
SO /nfs/homes/iantar/Desktop/cub3d_team/textures/SnowbrickL.xpm
WE /nfs/homes/iantar/Desktop/cub3d_team/textures/MultibrickL.xpm
EA /nfs/homes/iantar/Desktop/cub3d_team/textures/StoneUWL.xpm
   F  218,165,32
111111111111
1000N1000001
100000000001
100000000001
100000100001
100001000001
100000000001
100000000001
100000000001
111111111111
