
    C  225,30,0
    NO     ./path_to_the_north_texture
   SO      ./path_to_the_south_texture
  WE     ./path_to_the_west_texture
  EA    ./path_to_the_east_texture
   F  220,100,0
11111111111111111111111
1000N000000010000000011
10001000000001000001111
10010000001000101000011
10101010000100000100101
11111111111111111111111
