
    C  0,139,139
NO /nfs/homes/iantar/Desktop/cub3d_team/textures/GrasswallL.xpm
SO /nfs/homes/iantar/Desktop/cub3d_team/textures/SnowbrickL.xpm
WE /nfs/homes/iantar/Desktop/cub3d_team/textures/MultibrickL.xpm
EA /nfs/homes/iantar/Desktop/cub3d_team/textures/StoneUWL.xpm
   F  218,165,32
1111111111111111111111111
10000000000110000000000001
1000000001110000000000001111
10010000000000000000000011111111
111111111011000001110000000000001
100000000011000001110111111111111
11110111111111011100000010001
11110111111111011101010010001
11000000110101011100000000001
10000000000000001100000010001
10000000000000001101010010001
11000001110101011111011110N0111
11110111 1110101 101111010001
11111111 1111111 111111111111
