
11111101111
11010111111
11111111111
11111111111
11111111111