

    C  0,139,139
NO /nfs/homes/iantar/Desktop/cub3d_team/bonus/textures/GrasswallL.xpm
SO /nfs/homes/iantar/Desktop/cub3d_team/bonus/textures/SnowbrickL.xpm
WE /nfs/homes/iantar/Desktop/cub3d_team/bonus/textures/MultibrickL.xpm
EA /nfs/homes/iantar/Desktop/cub3d_team/bonus/textures/StoneUWL.xpm
   F  218,165,32
 1111111111111111111111111111111111111111
100000D0110000001001010000000000000000001
10000010100010000100100011100000000000011
10011000000100000010000000000000010000011
10000010001111111000010000110000000000D01
100000D0000000000100000000001000010000011
1000001011D111100100010000001000000000011
100010D0100000000000000001000000001000001
100100100001000000110000000000000010100N1
10011010000111110001001000000000000010001
10100010000101010000001000000011111010001
10110010000001010000001111110000001110001
10010010000100010000001000000001111000001
10000010000111110000001111110000000000001
 111111111111111111111111111111111111111 
