    C  0,139,139
NO /nfs/homes/iantar/Desktop/cub3d_team/bonus/textures/GrasswallL.xpm
SO /nfs/homes/iantar/Desktop/cub3d_team/bonus/textures/SnowbrickL.xpm
WE /nfs/homes/iantar/Desktop/cub3d_team/bonus/textures/MultibrickL.xpm
EA /nfs/homes/iantar/Desktop/cub3d_team/bonus/textures/StoneUWL.xpm
   F  218,165,32




         1111111111111111111111111
         1000000000110000000000N111
         111111111111000000000011111
11111111111111111111100011111111
1011000001110000000000001 
10010000000000000000001111111111
111111111011000001110000000000001
11110111111111011100000010001111
11110111 111111011101010010001
11000000110101011100000010001
10000000000000001100000010001
10000000000000001101010010001
1100000111010101111101111000111
11110111 1110101 101111010001
11111111 1111111 11111111111
111111111111111
